19 48
00 01 01 01 01 01 01 01 01 01 00 00 00 00 00 00 00 00 00 00 00 00 00 00 00 00 00 00 00 00 00 00 00 00 00 00 00 00 00 00 00 00 00 00 00 00 00 00
00 01 00 00 00 00 00 00 00 01 00 00 00 00 00 00 00 00 00 00 00 00 00 00 00 00 00 00 00 00 00 00 00 00 00 00 00 00 00 00 00 00 00 00 00 00 00 00
00 01 00 00 00 00 00 00 00 01 00 00 00 00 00 00 00 00 00 00 00 00 00 00 00 00 00 00 00 00 00 00 00 00 00 00 00 00 00 00 00 00 00 00 00 00 00 00
00 01 01 01 01 01 01 01 01 01 00 00 00 00 00 00 00 00 00 00 00 00 00 00 00 00 00 00 00 00 00 00 00 00 00 00 00 00 00 00 00 00 00 00 00 00 00 00
00 01 01 01 00 00 00 00 00 01 00 00 00 00 00 00 00 00 00 00 00 00 00 00 00 00 00 00 00 00 00 00 00 00 00 00 00 00 00 00 00 00 00 00 00 00 00 00
00 04 00 00 00 00 00 01 01 01 00 00 00 00 00 00 00 00 00 00 00 00 00 00 00 00 00 00 00 00 00 00 00 00 00 00 00 00 00 00 00 00 00 00 00 00 00 00
00 04 00 00 00 00 00 01 00 01 00 00 00 00 00 00 00 00 00 00 00 00 00 00 00 00 00 00 00 00 00 00 00 00 00 00 00 00 00 00 00 00 00 00 00 00 00 00
00 04 00 00 00 00 00 01 00 01 00 00 00 00 00 00 00 00 00 00 00 00 00 00 00 00 00 00 00 00 00 00 00 00 00 00 00 00 00 00 00 00 00 00 00 00 00 00
00 04 00 00 00 00 00 01 01 01 00 00 00 00 00 00 00 00 00 00 00 00 00 00 00 00 00 00 00 00 00 00 00 00 00 00 00 00 00 00 00 00 00 00 00 00 00 00
00 04 00 00 00 00 00 00 00 01 00 00 00 00 00 00 00 00 00 00 00 00 00 00 00 00 00 00 00 00 00 00 00 00 00 00 00 00 00 00 00 00 00 00 00 00 00 00
00 04 00 00 00 00 00 00 00 01 00 00 00 00 00 00 00 00 00 00 00 00 00 00 00 00 00 00 00 00 00 00 00 00 00 00 00 00 00 00 00 00 00 00 00 00 00 00
00 04 00 00 00 00 00 00 00 01 00 00 00 00 00 00 00 00 00 00 00 00 00 00 00 00 00 00 00 00 00 00 00 00 00 00 00 00 00 00 00 00 00 00 00 00 00 00
00 04 00 00 00 00 00 00 00 01 06 01 01 07 01 01 10 01 01 01 01 01 09 01 01 01 01 01 08 01 01 01 01 01 01 01 01 01 01 01 01 01 01 01 01 01 01 01
00 04 00 00 00 00 00 00 00 00 00 00 00 00 00 00 00 00 03 03 03 00 00 00 03 03 03 00 00 00 03 03 03 00 02 00 03 11 03 03 03 03 03 03 03 00 00 01
00 04 00 00 00 00 00 00 00 00 00 00 00 00 00 00 00 00 00 00 00 00 00 00 00 00 00 00 00 00 00 00 00 00 00 00 00 00 00 00 00 00 00 00 00 00 00 01
00 04 00 00 00 00 00 00 00 00 00 00 00 00 00 00 00 00 00 00 00 00 00 00 00 00 00 00 00 00 00 00 00 00 12 00 00 00 00 00 00 00 00 00 00 00 00 01
00 04 00 00 00 00 00 00 00 00 00 00 00 00 00 00 00 00 00 00 00 00 00 00 00 00 00 00 00 00 00 00 00 00 00 00 00 00 00 00 00 00 00 00 00 00 00 01
00 04 00 00 00 00 00 00 00 00 00 00 00 00 00 00 00 00 00 00 00 00 00 00 00 00 00 00 00 00 00 00 00 00 00 00 00 00 00 00 00 00 00 00 00 00 00 01
00 01 01 01 01 01 01 01 01 01 01 01 01 01 01 01 01 01 01 01 01 01 01 01 01 01 01 01 01 01 01 01 01 01 01 01 01 01 01 01 01 01 01 01 01 01 01 01


00 0 0

01 1 0

02 0 1
2 t
johnson_classroom
-y

03 5 1
3 a
* Nu am inteles de ce cineva
ar vrea sa foloseasca un locker.
* Adica nu avem ghiozdane?

04 3 0

05 4 0

06 1 1
4 a
* Asta e baia baietilor.
* Deschizi putin usa si te uiti
inauntru.
* Baia este albastra.

07 1 1
2 a
* Asta e baia feteler.
Nu ar trebui sa intru.

08 1 1
2 a
* Clasa lui Vacariu.
* Victor Vacariu.

09 1 1
3 a
* Clasa lui Flavian.
* Daca te uiti in interior,
parca vezi ramasitele unei shaorme.

10 1 1
4 a
* Clasa Deliei.
* O luminita rosie clipeste in interior. 
Este cam la nivelul obrazului unui om.

11 5 2
18 a
* Lockerul asta are foarte multe fisuri
in el. Aproape ca ai putea sa il 
* deschizi fara sa il spargi.
> Incerci sa il deschizi?
  2 9 2
> Da
> Nu
* L-ai desfacut cu usurinta. Te uiti
inauntru si vezi un fular. 
> Furi fularul?
  2 2 1
> Da
> Nu
* Ai obtinut fularul! Verifica in inventar.
* Golanule.
* Lasi fularul acolo.
* Decizi sa nu deschizi lockerul. Poate
ai facut o alegere buna.

2 b
first_locker_broken
0 1
2 i
first_locker_unbroken.png
background
2 i
first_locker_broken.png
background

12 0 1
0 s

